################################################################
....#...#.......#...#.......#...................................
........#...#...#...#...#...#...................................
@...#...#...#...#.......#...#...................................
....#...#...#...#...#...#.......................................
....#.......#.......#...#...#...................................
################################################################