############################################################################
.....#....#.........#....#....^....#.........#....#....^.........###########
..........#.........#..............#....^....#....^..............###########
@.........^....^.........^..................................^....*##########
.....^.........#..............#....^....#..............#....#....###########
.....#.........#....^....#....#.........#....^....#....#....#....###########
############################################################################