############################################################################
.....#....#.........#....#.........#....#....#....#....#.........###########
....*.....#....#....#....#....#....#.........#....#.........#....###########
@....#....#....#....#.........#....#....#....#....#....#....#....*##########
.....#....#....#....#....#....#.........#....#.........#....#....###########
.....#.........#.........#....#....#....#.........#....#....#....###########
############################################################################