############################################################################
.....#....#.........#....#.........#....#..#.#....#....#.........###########
..........#....#....#....#....#....#.......#.#....#.........#....###########
@....#....#....#....#.........#....#....#....#....#....#....#....*##########
.....#....#....#....#....#....#.........#..#.#.........#....#....###########
.....#.........#.........#....#....#....#..#......#....#....#....###########
############################################################################