#########################
#.....#.................#
#.#.#.#.#####.#####.#.#.#
#.#.#.#.#####.......#.#.#
#.#.#.#.#####.###########
#.#.#...................#
#.#.#################.#.#
#...#.....#...........#.#
#.#.#.###.#.#.#######.#.#
#.#.#...#.#.#...#...#.#.#
#.#...#.#.#.#.#####.#.#.#
#######.#.#.#.......#.###
#.......#.#.#######.#...#
#.#####.#.#.....#.....#.#
#.....#.#######.#.#####.#
#####.........#.#.....#.#
#...#.#######.#.#####.#.#
#.#.#.#.......#.#.....#.#
#.#.#.######.##.#.#####.#
#.#..@.....#.#......!*#.#
#########################