###########################
#@...#.#.#.#.#...#...#....#
#..#.#...#.....#.#.#.#.#.##
#.##.#.#.#.#####.#.#.#.#..#
#....#.#.#.....#.....#.##.#
#.####.#.####.##.###.#.#..#
#......#.#.....#.#...#...##
#####.##.#.###.#.#.###.#..#
#......#.#...#.#.#.....##.#
#.####.#.###.#.#.#####.#..#
###....#...#.###.#.#......#
#...##.#.#.....#.#.#.######
#.###..#...###...#...#....#
#..#..##.###...#.#.####.#.#
####.##......###.#..#...#.#
#.......##.#...#.#....#.#.#
###########################