#########################
#.......#...#.......#...#
#.#####.#.#.#.####.####.#
#.#.....#.#.#.#.......#.#
#.#.#.#.#.#...#.#####...#
#.#.#.#.#.#.#.#.#.#.#.###
#.#.#.#.#.#.#.###.#.#.#.#
#...#.#...#.#.....#.#.#.#
#########.#######.#.....#
#...#...........#.#.....#
#.###.########.##.....#.#
#...#.#...#....##.#.#.#.#
#.#...#.#.#.#####.#.#.#.#
#.###.#.#.#.#####.#.#...#
#...#...#...#######.###.#
#.#########.......#.....#
#..@.#....#.#####.#.###.#
##.#.#.#.##.#.....#..#..#
#..#...#....#.######!#*##
#########################