##############
#.....#..#*.##
#.#.#...###!.#
#.#.#.#..#..##
#...#.......##
##..#.##.#..##
##..#....##.##
#......#.#..##
##..###..##.##
###.##....#.##
###.#...###..#
#...#.###..#.#
#.#...#..#...#
#.#.#.......##
#.#.#.#.#.#.##
#@....#.#....#
##############