#.@.#########################
#...#...........#...........#
#...#.#.#######.#.#####.###.#
#...#.#.#.......#.#...#.#...#
#.#.#.#.#.#######.#.#.#.#.###
#.#.#.#.#.......#.#.#.#.#...#
#.#.#.#.#######.#.#.#.#.###.#
#.#.#.#.......#.#.#.#.#.#...#
#.#.#.#######.#.#.#.#.#.#.###
#.#...#.......#.#.#.#.#.#...#
#.#####.#####.#.#.#.#.#.###.#
#.....#.#.....#.#.#.#.#.#.#.#
#####.#.#.#####.#.#.#.#.#.#.#
#.....#.#.#.....#.#.#.#...#.#
#.#####.#.#######.#.#.#.#.###
#.....#.#.........#.#.#.#...#
#####.#.###########.#.#.#...#
#.....#.............#...#...#
#########################...#